0
n n n n n n n n n n n n n n n n
n n n n n n n n n n n n n n n n
n n s s s s s s s s s s s s n n							
n s n n n n n n n n n n n n s n								
s n n n n n n n n n n n n n n s								
s n n n s s s n n n n n n n n s								
s n n n n n n n n n n n n n n s								
s n n n n n n n n n n n n n s n								
n s n n n n n n n n n n n n s n								
n n s s s s s s s s s s s s n n								
n n n n n n n n n n n n n n n n
1
n n n n n n n n n n n n n n n n
n n n n n n n n n n n n n n n n
n n n n n n n n n n n n n n n n							
n s s s s s s s s s s s s s s n								
n s n n s n n n n n n n n n n s								
n n n n n n n n n n n n n n n s								
n n n n n s n n n n n n n n n s								
n s n n n n n n n n n n n n s n								
n s s s s s s s s s s s s s s n								
n n n n n n n n n n n n n n n n								
n n n n n n n n n n n n n n n n
2
n n n n n n n n n n n n n n n n
n n n s s s n n n n s s n n n n
n n s n n n s n n s n n s n n n							
n s s n n n s s s s n n s s n n								
s n n n n n n n n n n n n n s n								
n n n n n n n n n n n n n n s n								
n n n n n n n n n n n n n n s n								
s n s s s n n n n n s s s s n n								
s s n n n s n n n n s n n n n n								
n n n n n s n n n n s n n n n n								
n n n n n s n n n n s n n n n n
3
n n n n s s n n n n s s n n n n
n n n s n n n n n n n n s n n n
n n s n n n n n n n n n s n n n							
n n n s n n n n n n n n s n n n								
n n n s n n n n n n n n s n n n								
n n n s n n n n n n n n s n n n								
n n s n n n n n n n n n s n n n								
n n n s n n n n n n n n s n n n								
n n n n s n n n n n n n n s n n								
n n n n n s n n n n n n n n s n								
n n n n n s n n n n n n n n s n
4
n n n n n s n n n n n n n n s n
n n n n s n n n n n n n n n s n
s s s s n n n n n n n n n s n n							
n n n n n n n n n n n n s n n n								
n n n n n n n n n n n n s n n n								
n n n n n n n n n n n n s n n n								
n n n n n n n n n n n n s n n n								
n n n n n n n n n n n n s n n n								
n n n n n n n n n n n n s n n n								
n n n n n n n n n n n n s n n n								
s n n n n n n n n n n n s n n n
5
n n n n n n n n n n n n n n n n
n n n n n s s s s s s n n n n n
n n s s s n n n n n n s s s s s							
n s n n n n n n n n n n n n n n								
s n n n n n s s s s s n n n n n								
s n n n n s s n s n s s n n n n								
s n n n n s s n n n s s n n n n								
s n n n n s n s n s n s n n n n								
s n n n n n s s n s s n n n n n								
s n n n n n n s n s n n n n n n								
s n n n n n n n n n n n n n n s