Camara Resurrección
n n n n n n n n n n n n n n n n
n n n n n n n n n n n n n n n n
n n s s s s s s s s s s s s n n							
n s n n n n n n n n n n n n s n								
s n n n n n n n n n n n n n n s								
s n n n s s s n n n n n n n n s								
s n n n n l n n n n n n n n n s								
s n n n n n n n n n n n n n b n								
n s n n n n n n n n n n n n s n								
n n s s s s s s s s s s s s n n								
n n n n n n n n n n n n n n n n
Santuario Resurrección
n n n n n n n n n n n n n n n n
n n n n n n n n n n n n n n n n
n n n n n n n n n n n n n n n n							
n s s s s s s s s s s s s s s n								
n s n n c n n n n n n n n n n s								
n n n n n n n n n n n n n n n s								
n n n n n c n n n n n n n n n s								
n s n n n n n n n n n n n n b n								
n s s s s s s s s s s s s s s n								
n n n n n n n n n n n n n n n n								
n n n n n n n n n n n n n n n n
Great Plateau
n n n n n n n n n n n n n n n n
n n n s s s n n n n s s n n n n
n n s n n n s n n s n n s n n n							
n s s n n n s s s s n n s s n n								
s n n n n n n n n n n n n n s n								
n n n n n n n n n n n n n n s n								
n n n n n n n n n n n n n n s n								
s n s s s n n n n n s s s s n n								
s s n n n s n n n n s n n n n n								
n n n n n s n n n n s n n n n n								
n n n n n s n n n n s n n n n n
null

null

El mapa del viejo
n n n n s s n n n n s s n n n n
n n n s n n n n n n n n s n n n
n n s n n n n n n n n n s n n n							
n n n s n n n n n n n n s n n n								
n n n v n n n n n n n n s n n n								
n n n s n n n n n n n n s n n n								
n n s n n n n n n n n n s n n n								
n n n s n n n n n n n n s n n n								
n n n n s n n n n n n n n s n n								
n n n n n s n n n n n n n n s n								
n n n n n s n n n n n n n n s n
null

La Espada
n n n n n n n n n n n n n n n n
n n n n n s s s s s s n n n n n
n n s s s w w w w w w s s s s s							
n s w w w w w w w w w w w w w w								
s w w w w w s s s s s w w w w w								
s w w w w s s n e n s s w w w w								
s w w w w s s n n n s s w w w w								
s w w w w s n s n s n s w w w w								
s w w w w w s s n s s w w w w w								
s w w w w w w s n s w w w w w w								
s w w w w w w w w w w w w w w s
Primeros Moblins
n n n n n s n n n n n n n n s n
n n n n s n n n n n n n n n s n
s s s s n n n n n n n n n s n n							
w w w n n n n n n n n n s n n n								
w w w n n n n n n n n n s n n n								
w w w n n n n n n n n n s n n n								
w w w n n n n n n n n n s n n n								
w w w n n n n n n n n n s n n n								
w w w n n n n n n n n n s n n n								
w w w n n n n n n n n n s n n n								
s w w n n n n n n n n n s n n n